****    **
**** **  *
* *   *** 
 * *  **  
**** * * *
**  *  ** 
          
**  **  **
*****     
     *****