****    **
  * **  *
* *   * * 
 * *  **  
   * * * *
**  *  ** 
          
**  **  **
*  **     
     *  **