**** ** **
**** **  *
* ******* 
 * *  **  
**** * * *
**  *  ** 
   **     
**  **  **
*****     
**********